{
  "Levels": {
    "1": [
      "###################",
      "#    #    #       #",
      "# ## # #  # ##### #",
      "# #      #     #  #",
      "# #####  # # # #  #",
      "#        # # # #  #",
      "# ### ### # # # # #",
      "#     #   # #   # #",
      "# ####### # ##### #",
      "#         #       #",
      "# ### ##### #######",
      "#     #           #",
      "# ##### ######### #",
      "#     #   #     # #",
      "# ####### ### # # #",
      "#       #   # # # #",
      "# ######### # # # #",
      "#                 #",
      "###################"
    ],
    "2": [
      "###################",
      "##   #    #       #",
      "# ## # #  # ##### #",
      "# #      #     #  #",
      "# #####  # # # #  #",
      "#        # # # #  #",
      "##### ### # # # # #",
      "#     #   # #   # #",
      "# ####### # ##### #",
      "#         #       #",
      "######### #########",
      "#     #           #",
      "# ##### ######### #",
      "#     #   #     # #",
      "####### # ### # # #",
      "#       #   # # # #",
      "# ######### # # # #",
      "#                 #",
      "###################"
    ]
  }
}